60
WWWWWWWWWWWWWWWWWWWWWWWWWWWWWWWWWWWWWWWWWWWWWWWWWWWWWWWWWWWW
WWWWWWWWWWWWWWWWWWWWWWWWWWWWWWWWWWWWWWWWWWWWWWWWWWWWWWWWWWWW
WWWWWWWWWWWWWWWWWWWWWWWWWWWWWWWWEEEEEEEEEEEEEEEEWWWWWWWWWWWW
WWWWWWWWWWWWWWWWWWWWWWWWWWWEEEEEEEEEEEEEEEEEEEEEEEWWWWWWWWWW
WWWWWWWWWWWWWWWWWWWWWWWEEEEEEEEEEEEEEEEEEEEEEEEEEEEEWWWWWWWW
WWWWWWWWWWWWWWWWWWWWWWEEEEEEEEEEEEEEEEEEEEEEEEEEEEEEEWWWWWWW
WWWWWWWWWWWWWWWWWWWWEEEEEEEEEEEEEEEEEEEEEEEEEEEEEEEEEEWWWWWW
WWWWWWWWWWWWWWWWWWEEEEEEEEEEEEEEEEEWWEEEEEEEEEEEEEEEEEEWWWWW
WWWWWWWWWWWWWWWWWEEEEEEEEEEEEEEEEEWWWWWEEEEEEEEEEEEEEEEEWWWW
WWWWWWWWWWWWWWWEEEEEEEEEEEEEEEEEEWWWWWWWEEEEEEEEEEEEEEEEWWWW
WWWWWWWWWWWWWWEEEEEEEEEEEEEEEEEEEWWWWWWWWEEEEEEEEEEEEEEEEWWW
WWWWWWWWWWWWWEEEEEEEEEEEEEEEEEEEEWWWWWWWWEEEEEEEEEEEEEEEEWWW
WWWWWWWWWWWWEEEEEEEEEEEEEEEEEEEEEEWWWWWWWEEEEEEEEEEEEEEEEEWW
WWWWWWWWWWWEEEEEEEEEEEEEEEEEEEEEEEEWWWWWWEEEEEEEEEEEEEEEEEWW
WWWWWWWWWWWEEEEEEEEEEWWWWEEEEEEEEEEEWWWWEEEEEEEEEEEEEEEEEEWW
WWWWWWWWWWEEEEEEEEEEWWWWWWWEEEEEEEEEWWWWEEEEEEEEEEEEEEEEEEWW
WWWWWWWWWWEEEEEEEEEWWWWWWWWWEEEEEEEEEWWEEEEEEEEEEEEEEEEEEEWW
WWWWWWWWWEEEEEEEEEWWWWWWWWWWEEEEEEEEEEEEEEEEEEEEEEEEEEEEEEWW
WWWWWWWWEEEEEEEEEEWWWWWWWWWEEEEEEEEEEEEEEEEEEEWWWWEEEEEEEEWW
WWWWWWWWEEEEEEEEEEEWWWWWWWEEEEEEEEEEEEEEEEEEEWWWWWWEEEEEEEWW
WWWWWWWEEEEEEEEEEEEWWWWWWEEEEEEEEEEEEEEEEEEEEWWWWWWEEEEEEEWW
WWWWWWWEEEEEEEEEEEEEWWWWWEEEEEEEEEEEEEEEEEEEWWWWWWWEEEEEEEWW
WWWWWWEEEEEEEEEEEEEEEEWWEEEEEEEEEEEEEEEEEEEWWWWWWWWEEEEEEEWW
WWWWWWEEEEEEEEEEEEEEEEEEEEEEEEEEEEEEEEEEEEEWWWWWWWWEEEEEEEWW
WWWWWWEEEEEEEEEEEEEEEEEEEEEEEEEEEEEEEEEEEEEWWWWWWWEEEEEEEEWW
WWWWWEEEEEEEEEEEEEEEEEEEEEEEEEEWWEEEEEEEEEEEWWWWWEEEEEEEEEWW
WWWWWEEEEEEEEEEEEEEEEEEEEEEEEWWWWWEEEEEEEEEEEWWWEEEEEEEEEEWW
WWWWEEEEEEEEEEEEEEEEEEEEEEEEWWWWWWWWEEEEEEEEEEEEEEEEEEEEEEWW
WWWWEEEEEEEEEEWWWEEEEEEEEEEEWWWWWWWWEEEEEEEEEEEEEEEEEEEEEEWW
WWWWEEEEEEEEEWWWWWEEEEEEEEEWWWWWWWWWWEEEEEEEEEEEEEEEEEEEEEWW
WWWEEEEEEEEEEWWWWWWWEEEEEEEWWWWWWWWWWEEEEEEEEEEEEEEEEEEEEEWW
WWWEEEEEEEEEWWWWWWWWEEEEEEEEWWWWWWWWWEEEEEEEEEEEEEEEEEEEEEWW
WWWEEEEEEEEWWWWWWWWWWEEEEEEEWWWWWWWWEEEEEEEEEEEEEEEEEEEEEEWW
WWEEEEEEEEEWWWWWWWWWWEEEEEEEEWWWWWWEEEEEEEEEEEEEEEEEEEEEEEWW
WWEEEEEEEEEWWWWWWWWWWEEEEEEEEEWWWEEEEEEEEEEEEEEEEEEEEEEEEEWW
WWEEEEEEEEEWWWWWWWWWWEEEEEEEEEEEEEEEEEEEEEEEEEEEEEEEEEEEEEWW
WWEEEEEEEEEWWWWWWWWWWEEEEEEEEEEEEEEEEEEEEEEEEEEEEEEEEEEEEEWW
WWEEEEEEEEEEWWWWWWWWEEEEEEEEEEEEEEEEEEEEEEEEEEEEEEEEEEEEEEWW
WWEEEEEEEEEEEWWWWWWEEEEEEEEEEEEEEEEEEEEEEEEEEEEEEEEEEEEEEEWW
WWEEEEEEEEEEEEEEEEEEEEEEEEEEEEEEEEEEEEEEEEWWWWEEEEEEEEEEEEWW
WWEEEEEEEEEEEEEEEEEEEEEEEEEEEEEEEEEEEEEEEWWWWWWEEEEEEEEEEEWW
WWEEEEEEEEEEEEEEEEEEEEEEEEEEEEEEEEEEEEEEWWWWWWWWEEEEEEEEEEWW
WWEEEEEEEEEEEEEEEEEEEEEEEEEEEEEEEEEEEEEWWWWWWWWWEEEEEEEEEEWW
WWEEEEEEEEEEEEEEEEEEEEEEEEWWEEEEEEEEEEEWWWWWWWWWEEEEEEEEEEWW
WWEEEEEEEEEEEEEEEEEEEEEEWWWWWEEEEEEEEEEWWWWWWWWEEEEEEEEEEWWW
WWEEEEEEEEEEEEEEEEEEEEEWWWWWWWEEEEEEEEEWWWWWWWEEEEEEEEEEEWWW
WWEEEEEEEEEEEEEEEEEEEEEWWWWWWWEEEEEEEEEEWWWEEEEEEEEEEEEEEWWW
WWEEEEEEEEEEEEEEEEEEEEWWWWWWWWEEEEEEEEEEEEEEEEEEEEEEEEEEWWWW
WWWEEEEEEEEEEEEEEEEEEEWWWWWWWEEEEEEEEEEEEEEEEEEEEEEEEEEEWWWW
WWWEEEEEEEEEEEEEEEEEEEEWWWWWEEEEEEEEEEEEEEEEEEEEEEEEEEEWWWWW
WWWEEEEEEEEEEEEEEEEEEEEEWWWEEEEEEEEEEEEEEEEEEEEEEEEEEEEWWWWW
WWWEEEEEEEEEEEEEEEEEEEEEEEEEEEEEEEEEEEEEEEEEEEEEEEEEEEWWWWWW
WWWWEEEEEEEEEEEEEEEEEEEEEEEEEEEEEEEEEEEEEEEEEEEEEEEEEWWWWWWW
WWWWEEEEEEEEEEEEEEEEEEEEEEEEEEEEEEEEEEEEEEEEEEEEEEEEWWWWWWWW
WWWWWEEEEEEEEEEEEEEEEEEEEEEEEEEEEEEEEEEEEEEEEEEEEEWWWWWWWWWW
WWWWWEEEEEEEEEEEEEEEEEEEEEEEEEEEEEEEEEEEEEEEEEEEWWWWWWWWWWWW
WWWWWWEEEEEEEEEEEEEEEEEEEEEEEEEEEEEEEEEEEEEWWWWWWWWWWWWWWWWW
WWWWWWWWWWEEEEEEEEEEEEEEEEEEEEEEWWWWWWWWWWWWWWWWWWWWWWWWWWWW
WWWWWWWWWWWWWWWWWWWWWWWWWWWWWWWWWWWWWWWWWWWWWWWWWWWWWWWWWWWW
WWWWWWWWWWWWWWWWWWWWWWWWWWWWWWWWWWWWWWWWWWWWWWWWWWWWWWWWWWWW
